  XX   X
   XX  X
X  XX  X
X      X
XXX  XXX
